0000000000000000000000000000000000000000000000000000000000000000000000000000000000000000000000000000
0000000000000000000000000000000000000000000000000000000000000000000000000000000000000000000000000000
0000000000000000000000000000000000000000000000000000000000000000000000000000000000000000000000000000
0000000000000000000000000000000000000000000000000000000000000000000000000000000000000000000000000000
0000000000000000000000000000000000000000000000000000000000000000000000000000000000000000000000000000
0000000000000000000000000000000000000000000000000000000000000000000000000000000000000000000000000000
0000000000000000000000000000000000000000000000000000000000000000000000000000000000000000000000000000
0000000000000000000000000000000000000000000000000000000000000000000000000000000000000000000000000000
0000000000000000000000000000000000000000000000000000000000000000000000000000000000000000000000000000
0000000000000000000000000000000000000000000000000000000000000000000000000000000000000000000000000000
0000000000000000000000000000000000000000000000000000000000000000000000000000000000000000000000000000
0000000000000000000000000000000000000000000000000000000000000000000000000000000000000000000000000000
0000000000000000000000000000000000000000000000000000000000000000000000000000000000000000000000000000
0000000000000000000000000000000000000000000000000000000000000000000000000000000000000000000000000000
0000000000000000000000000000000000000000000000000000000000000000000000000000000000000000000000000000
0000000000000000000000000000000000000000000000000000000000000000000000000000000000000000000000000000
0000000000000000000000000000000000000000000000000000000000000000000000000000000000000000000000000000
0000000000000000000000000000000000000000000000000000000000000000000000000000000000000000000000000000
2000000000000000000000000000000000000000000000000000000000000000000000000000000000000000000000000022
4200000000000000000000000000000000000000000000000000000000000000000000000000000000000000000000002244
1422220000000000000000000000000000000000000000000000000000000000000000000000000000000000000002224411
1144442222000000000000000000000000000000002222222222220000000000000000000000000000000000000224441111
1111114444222222222222222200000000000222224444444444442222222222222222000000000222222222222441111111
1111111111444444444444444400000000000444441111111111114444444444444444000000000444444444444111111111
1111111111111111111111111133333333333111111111111111111111111111111111333333333111111111111111111111
1111111111111111111111111133333333333111111111111111111111111111111111333333333111111111111111111111
1111111111111111111111111133333333333111111111111111111111111111111111333333333111111111111111111111
1111111111111111111111111133333333333111111111111111111111111111111111333333333111111111111111111111


